organizations	organizations
stores	stores
adminUsers	admin_users
auditLogs	audit_logs
systemConfigs	system_configs
permissionRules	permission_rules
depositAccounts	deposit_accounts
settlementRules	settlement_rules
crossStoreLedger	cross_store_ledger
settlementBatches	settlement_batches
refundRecords	refund_records
financialReports	financial_reports
campaigns	campaigns
coupons	coupons
userCoupons	user_coupons
sduiLayouts	sdui_layouts
geoFenceRules	geo_fence_rules
weatherTriggers	weather_triggers
categories	categories
products	products
skuAttributes	sku_attributes
productSkus	product_skus
storePrices	store_prices
timeSlotMenus	time_slot_menus
iikoShadowMenu	iiko_shadow_menu
priceChangeLogs	price_change_logs
dataPipelines	data_pipelines
aiReports	ai_reports
translationReviews	translation_reviews
aiSuggestions	ai_suggestions
vectorEmbeddings	vector_embeddings
llmCallLogs	llm_call_logs
orders	orders
orderItems	order_items
orderDiscounts	order_discounts
reviews	reviews
reviewImages	review_images
mallProducts	mall_products
mallOrders	mall_orders
mallOrderItems	mall_order_items
mallInventory	mall_inventory
logisticsTracking	logistics_tracking
influencers	influencers
influencerTasks	influencer_tasks
taskSubmissions	task_submissions
influencerCommissions	influencer_commissions
withdrawalRequests	withdrawal_requests
referralLinks	referral_links
chatSessions	chat_sessions
chatMessages	chat_messages
aiIntents	ai_intents
quickReplies	quick_replies
faqEntries	faq_entries
telegramBotConfig	telegram_bot_config
users	users
userAddresses	user_addresses
userPoints	user_points
giftCards	gift_cards
smsProviders	sms_providers
smsVerificationLogs	sms_verification_logs
phoneBindings	phone_bindings
sensitiveActionLogs	sensitive_action_logs
securityTokens	security_tokens
verificationRules	verification_rules
riskControlLogs	risk_control_logs
captchaConfigs	captcha_configs
captchaVerifyLogs	captcha_verify_logs
securityRules	security_rules
securityAuditLogs	security_audit_logs
blockedEntities	blocked_entities
translations	translations
translationAuditLog	translation_audit_log
offlineRedemptionQueue	offline_redemption_queue
userTrustScores	user_trust_scores
